"filename", "language", "CSS", "comment", "blank", "total"
"d:\UAC TRY-1\static\uac\styles\404.css", "CSS", 60, 0, 5, 65
"d:\UAC TRY-1\static\uac\styles\about.css", "CSS", 479, 4, 76, 559
"d:\UAC TRY-1\static\uac\styles\base.css", "CSS", 174, 2, 38, 214
"d:\UAC TRY-1\static\uac\styles\goods.css", "CSS", 279, 2, 54, 335
"d:\UAC TRY-1\static\uac\styles\home.css", "CSS", 635, 5, 81, 721
"d:\UAC TRY-1\static\uac\styles\more.css", "CSS", 569, 10, 73, 652
"d:\UAC TRY-1\static\uac\styles\payment_success.css", "CSS", 654, 0, 19, 673
"d:\UAC TRY-1\static\uac\styles\reserve.css", "CSS", 190, 2, 42, 234
"d:\UAC TRY-1\static\uac\styles\result1.css", "CSS", 699, 63, 86, 848
"d:\UAC TRY-1\static\uac\styles\select.css", "CSS", 371, 2, 71, 444
"d:\UAC TRY-1\static\uac\styles\ships.css", "CSS", 486, 8, 68, 562
"d:\UAC TRY-1\static\uac\styles\success.css", "CSS", 294, 2, 63, 359
"d:\UAC TRY-1\static\uac\styles\test1.css", "CSS", 257, 2, 58, 317
"d:\UAC TRY-1\static\uac\styles\tickets.css", "CSS", 252, 2, 51, 305
"d:\UAC TRY-1\static\uac\styles\transport.css", "CSS", 0, 0, 1, 1
"d:\UAC TRY-1\static\uac\styles\xwing.css", "CSS", 340, 5, 53, 398
"Total", "-", 5739, 109, 839, 6687